*π‘Άπ‘§π‘¤π‘¥	π‘£π‘Άπ‘§π‘¤π‘¥
*π‘Άπ‘§π‘¤π‘¥π‘›	π‘£π‘Άπ‘§π‘¤π‘¥π‘›
*π‘Άπ‘§π‘¤π‘¥π‘	π‘£π‘Άπ‘§π‘¤π‘¥π‘
*π‘¬π‘Ό	π‘£π‘¬π‘Ό
*π‘¬π‘Όπ‘	π‘£π‘¬π‘Όπ‘
axolotl	π‘¨π‘’π‘•π‘©π‘¤π‘π‘‘π‘©π‘¤	0
derp	π‘›π‘»π‘	0
ender	π‘§π‘―π‘›π‘Ό	0
either	π‘°π‘π‘Ό	27766
filthed	π‘“π‘¦π‘¤π‘”π‘‘	0
filths	π‘“π‘¦π‘¤π‘”π‘•	0
horologe	π‘£π‘π‘®π‘©π‘¤π‘π‘΅	0
hour	π‘£π‘¬π‘Ό	0
hours	π‘£π‘¬π‘Όπ‘	0
iyk	π‘²π‘’	10000000000
nerd	π‘―π‘»π‘›	0
nerds	π‘―π‘»π‘›π‘	0
quidditch	π‘’π‘Άπ‘¦π‘›π‘¦π‘—	0
rhotic	π‘®π‘π‘‘π‘¦π‘’	0
tion	π‘–π‘©π‘―	0
whelm	π‘£π‘Άπ‘§π‘¤π‘¥	0
whelmed	π‘£π‘Άπ‘§π‘¤π‘¥π‘›	0
whelms	π‘£π‘Άπ‘§π‘¤π‘¥π‘	0
women	π‘Άπ‘¦π‘¥π‘©π‘―	39886